4

30
50
..................................................
..................................................
..................................................
.....##############..............############.....
.....#.........#..#..............#..........#.....
.....#.#######.#.##..............#.########.#.....
.....#.#.....#....#..............#.#......#.#.....
.....#.#.#####.####..............#.#.####.#.#.....
.....#.#.....#...#################.#.##.#...#.....
.....#.#####.###........................#.#.#.....
.....#.........#.###############.#.##########.....
.....#########.#.#.#...........#.#..#.............
.............#.#.#.#...........###.##.............
.............#.#.#.#...........#....#.............
.............#.#...#...........#.##.#.............
.............#######...........#.##.#.............
.............#.................#.#..#.............
.............#.#################.####.............
.....#########...#.................##########.....
.....#.........###.#.#.##########.#######.#.#.....
.....#.#########.....#.#..........#.....#.#.#.....
.....#.#.........#####.##########.#.###.#.#.#.....
.....#.######.#####...........#.#.#.#.#.#.#.#.....
.....#......#.....#...........#.....#.#.#.#.#.....
.....#.##########.#...........#####.#.#.#.#.#.....
.....#............#...........#...........#.#.....
.....##############...........###############.....
..................................................
..................................................
..................................................

30
50
..................................................
..................................................
..................................................
.....##############..............############.....
.....#.........#..#..............#..........#.....
.....#.#######.#.##..............#.########.#.....
.....#.#.....#....#..............#.#......#.#.....
.....#.#.#####.####..............#.#.####.#.#.....
.....#.#.....#...#################.#.##.#...#.....
.....#.#####.###........................#.#.#.....
.....#.........#.#################.##########.....
.....#########.#.#.............#....#.............
.............#.#.#.#...........#.##.#.............
.............#.#.#.#...........#.#..#.............
.............#.#...#...........#.####.............
.............#######...........#.#..#.............
.............#.................#.#..#.............
.............#.#################.####.............
.....#########...#...#..............#########.....
.....#.........#####.#.##########.#######.#.#.....
.....#.#########.....#.#..........#.....#.#.#.....
.....#.#.........#####.##########.#.###.#.#.#.....
.....#.######.#####...........#.#.#.#.#.#.#.#.....
.....#......#.....#...........#.....#.#.#.#.#.....
.....#.##########.#...........#####.#.#.#.#.#.....
.....#............#...........#...........#.#.....
.....##############...........###############.....
..................................................
..................................................
..................................................

30
50
..................................................
..................................................
..................................................
.....##############..............############.....
.....#.........#.##..............#..........#.....
.....#.#######.#..#..............#.########.#.....
.....#.#.....#.#.##..............#.#......#.#.....
.....#.#.#####.#..#..............#.#.##.#.#.#.....
.....#.#.....#.##.##################.#..#...#.....
.....#.#####.#.#...................#.##.#.#.#.....
.....#.........###################.##########.....
.....#########...#.............#.#..#.............
.............#.#.#.#...........#.##.#.............
.............#.#.#.#...........#....#.............
.............#.#...#...........#.####.............
.............#.#####...........#.#..#.............
.............#.#...............#.#..#.............
.............#.#################.####.............
.....#########...#................###########.....
.....#.........#####.#.#.########.#######.#.#.....
.....#.#########.....#.#..........#.....#.#.#.....
.....#.#.........#####.############.###.#.#.#.....
.....#.######.#####...........#.#.#.#.#.#.#.#.....
.....#......#.....#...........#.....#.#.#.#.#.....
.....#.##########.#...........#####.#.#.#.#.#.....
.....#............#...........#...........#.#.....
.....##############...........###############.....
..................................................
..................................................
..................................................

30
50
..................................................
..................................................
..................................................
.....##############..............############.....
.....#.........#..#..............#..........#.....
.....#.#######.#.##..............#.########.#.....
.....#.#.....#....#..............#.#......#.#.....
.....#.#.#####.####..............#.#.####.#.#.....
.....#.#.....#...#################.#.##.#...#.....
.....#.#####.###........................#.#.#.....
.....#.........#.###############.#.##########.....
.....#########.#.#.#...##...#..#.#..#.............
.............#.#.#.#.#..#.#.#..###.##.............
.............#.#.#.#.#..#.#.#..#....#.............
.............#.#...#.#..#.#.#..#.##.#.............
.............#######..#.#.#.#.#.##.#.............
.............#........#...#...#.#..#.............
.............#.#################.####.............
.....#########...#.................##########.....
.....#.........###.#.#.##########.#######.#.#.....
.....#.#########.....#.#..........#.....#.#.#.....
.....#.#.........#####.##########.#.###.#.#.#.....
.....#.######.#####...........#.#.#.#.#.#.#.#.....
.....#......#.....#...........#.....#.#.#.#.#.....
.....#.##########.#...........#####.#.#.#.#.#.....
.....#............#...........#...........#.#.....
.....##############...........###############.....
..................................................
..................................................
..................................................